1111111111
1P00000011
1E01111001
1C00000001
1111111111