1111111111
1P00000011
1001111001
1CE0000001
1111111111