1111111111
1P000C0011
1011111111
1E00000001
1111111111