1111111111
1P000000E1
1001111001
1C00000001
1111111111
