111111111111111111
1P0000000000000001
101111111101111101
100000000010000001
100111111110111101
100000000000000001
1C0111111111111101
1E0000000000000001
111111111111111111
