111111111111111111111111111111
1P000000000000C0000000000000E1
101111111111101111111111111101
100000000000100000000000000001
100111111110100111111111110001
1C0000000000000000000000000001
101111111111101111111111111101
100000000000100000000000000001
100111111111100111111111110001
1C0000000000000000000000000001
101111111111101111111111111101
100000000000100000000000000001
100111111110100111111111110001
1C0000000000000000000000000001
111111111111111111111111111111
